11 0 0 0 0 0 0 0 0 0 105
0 0 0 0 0 0 0 0 0 0 0
0 0 0 0 0 0 0 0 0 0 0
0 0 0 0 0 0 0 0 0 0 0
0 0 0 0 0 0 0 0 0 0 0
0 0 0 0 0 1 0 0 0 0 0
0 0 0 0 0 0 0 0 0 0 0
0 0 0 0 0 0 0 0 0 0 0
0 0 0 0 1 4 1 0 0 0 0
0 0 0 0 1 5 1 0 0 0 0
104 0 0 1 1 111 1 1 0 0 102