11 0 -1 -2 -1 0 0 0 0 0 0
1  1  1  1  1 1 1 1 1 1 0
10 0  0  2  0 1 13 7 0 1 0
0 -5 0 1 0 1 14 10 0 1 0
1 2 1 1 0 1 1 1 2 1 0
7 0 0 1 0 2 -3 -4 -3 1 0
0 -6 0 1 0 1 1 1 1 1 0
1 2 1 1 0 0 0 0 0 0 0
13 0 13 1 1 2 1 1 1 2 1
10 0 7 1 7 0 101 1 0 -3  0
10 20 7 1 0 100 0 1 -1 10 -1