12 0 3 0 0 0 0 0 0 0 0
0 0 1 1 0 -7  0 -7 0 1 1 
0 1 1 1 1 1 0 1 1 1 1
0 1 7 7 1 0 0 0 1 0 101
0 1 7 0 6 0 0 0 6 0 0
0 1 1 1 1 0 0 0 1 1 1
0 1 103 0 1 0 0 0 1 0 102
0 1 0 0 6 0 0 0 6 0 0
0 1 1 1 1 0 0 0 1 1 1
0 1 10 10 1 0 0 0 1 13 13
11 1 10 0 6 0 0 0 6 14 14