7 14 1 7 10 7 1 0 1 0 10
0 10 1 10 7 10 1 0 2 -3 0
-4 0 1 7 8 7 1 0 1 1 1
2 1 1 1 0 1 1 0 1 0 101
0 0 -3 0 0 0 -1 0 0 0 0
2 1 1 0 0 0 1 0 1 1 1
-5 0 1 1 0 1 1 0 1 0 10
0 7 1 0 0 0 1 0 2 -4 7
10 13 1 0 0 0 1 0 1 1 1
1 1 1 1 0 1 1  -2 1 0 0
12 0 0 0 0 0 1 0 2 0 11