15 15 15 15 15 15 15 15 15 15 15 
15 15 15 15 15 15 15 15 15 15 15 
15 15 15 15 1 1 1 15 15 15 15 
15 15 15 1 1 1 1 1 15 15 15 
15 15 15 1 1 51 1 1 15 15 15 
15 15 15 1 1 15 1 1 15 15 15 
15 15 15 15 1 15 1 15 15 15 15 
15 15 15 15 15 15 15 15 15 15 15 
15 15 15 15 15 15 15 15 15 15 15 
1 1 1 1 1 2 1 1 1 1 1 
12 0 0 0 0 0 0 0 0 0 11