12 0 2 3 0 11 0 1 13 9 13
0 0 1 1 -4 0 -5 1 0 52 0
2 1 1 1 1 2 1 1 14 0 14
0 1 7 7 0 0 0 1 1 5 1
10 1 1 1 1 1 -4 1 -8 0 -8
0 -1 -2 -3 0 1 0 1 0 0 0
1 1 1 1 0 1 0 1 1 5 1
0 0 0 -3 0 -4 0 1 -6 0 -6
2 1 1 1 1 1 1 1 0 0 0
-1 0 1 13 0 2 -5 3 0 0 101
0 -3 0 0 14 1 8 1 1 1 1