1 1 13 14 1 1 1 1 1 1 1
1 0 0 0 0 1 0 1 1 1 1
0 0 0 0 -9 1 0 0 1 1 1
0 0 0 0 -9 1 0 0 0 1 1
0 0 0 0 -9 1 0 0 0 0 1
12 0 0 0 0 5 0 0 0 0 -30
0 0 0 0 -10 1 0 0 0 0 1
0 0 0 0 -10 1 0 0 0 1 1
0 0 0 0 -10 1 0 0 1 1 1
1 0 0 0 0 1 0 1 1 1 1
1 1 13 14 1 1 1 1 1 1 1